NO ./textures/bricks.xpm42
SO ./textures/grass.xpm42
WE ./textures/ugly_thing.xpm42
EA ./textures/wood.xpm42
DO ./textures/door.xpm42

F 30,30,30
C 30,30,200

111111111
1S0100001
100D01D11
100101001
111111111