NO ./textures/bricks.xpm42
SO ./textures/grass.xpm42
WE ./textures/ugly_thing.xpm42
EA ./textures/wood.xpm42
DO ./textures/door.xpm42

F 30,30,30
C 30,30,200

11111111111
1S010000D01
100D011D101
10010100101
1111111D101
10000000101
1D111111101
10000000001
11111111111
