NO ./textures/planks_x64_2.xpm42
SO ./textures/random-greenery-30.xpm42
WE ./textures/tile359.xpm42
EA ./textures/wall_64x64_0.xpm42
F 30,30,30
C 30,30,200

11111
1W001
100011111
101000001
101011111
11111
