NO ./textures/tyles/bricks.xpm42
SO ./textures/tyles/drinks.xpm42
WE ./textures/tyles/gibbon.xpm42
EA ./textures/tyles/wood.xpm42
DO ./txtures/doors/42_door.xpm42

F 30,30,30
C 30,30,200

11111111111
1111111N01
100000000111111111111111111111111111111111111111111111111111111111111111111111111111111111111111111111111111111111111111111111111111111111111111111111111111111111111111111111111111111111111111111111111111111111111111111
1000000000000000000000000000000000000000000000000000000000000000000000000000000000000000000000000000000000000000000000000000000000000000000000000000000000000000000000000000000000000000000000000000000000000000000000000001
1000000010111111111111111111111111111111111111111111111111111111111111111111111111111111111111111111111111111111111111111111111111111111111111111111111111111111111111111111111111111111111111111111111111111111111111111111
11111111101
10000001011
10111111101
10000000001
11111111111
